sequence	class
AGTCGCAAAAGATGTTCCGGGGACAGGAAGTAATATGGACACCGTTGACA	Healthy
CTCCAGTGTCACACAATCCCACTCGCCAATTATGGTTTCGGCCGTGAATT	Healthy
ATCACTTTCTCCCACGATGTAAAAGCCGCATATCGATGGGTAGAGAAGAT	Healthy
TACAGGGTCTTGTCAGCGACAGCTCGTTCGGAAGGAATTTCGTAGGAGGA	Disease
CAGGAAGGGTGAATGAGAAGACCCAAAACGCAAGTTACGCCTATGCGGCC	Disease
TTTAGTCTCGTTGATTAAAGGTGTCCACTTTAATTTGTCTCGGGGGGCGA	Disease
TAGTGGTAGTAACACACGTAAGCTTGGGACTGCCTTCATCTTCCGCTTAA	Healthy
TTGTTCCGTTCATCGACGATACATCGGTGAAGGCCAAAAATTTCTTCAGG	Disease
ATCTCCTGCTAGTATGATGCCTCAACAAGCCCACGGAGCCGCGCGCGGTG	Disease
CCAAATATATCGGACCGACATTAATTTACGAAGCCTGTGCAGATCATGTT	Healthy
TGTACTATTGTGAACATACTCATCTTTTCACCGTACTTGCATAGTATAAA	Healthy
TGCAGGACTACCACTAATCCTCGTGCAGTCCTCCCTTATCCGTACTTTTG	Disease
GCTGACAGAGTACAGAGAAACCATTTCATCAGCCAGATATTTGGAGAAAC	Disease
TCTGTCCTGCGAACCTCTTCACTAAGCAAAGACGTTGCAGCTGCCGGCTA	Healthy
GCTCGGTCCAGGCCACAATGACGCATTAACAAAGATCCCATTGCGCTCTG	Disease
GAACTAAATTAAGCACGGGGAAAATTCTACTACGAGGTAGTTACCGCTGA	Disease
TCCACTCTCGTATCGCTACATCGTTAGTAGGACAAGTCTACATAACCATC	Healthy
ATGAGTCGCGGGGTGCTGTACCATACGAACGTGTGCCCAAACGTGTAAAT	Disease
CCTATATTGGACAGCTCCTCCCTGTAGGAAAAAGCATTAAGCGTTGCCAT	Healthy
AGTGAGGTCTCGCATATGTCACGGGTGCCACTTACGCATCTCAGGCGTAG	Healthy
TTTATTCGACGACGTTCGTCCGGTAGAGTCTTGAGGCGGGTTACCTGTGA	Disease
TGGGGGTCTAAGCCGATAGGCAGATTAGTCCCCTTGCAAAACCATACGTT	Healthy
GAATAAACTGCTGAATTGCAAGTCATAATCTTGCAGTTGTAGCTTAAAGC	Disease
TCAAGCTTTATACCTGTCTTGTCATAGCGACTATCGGTAGTCGTCAAATT	Healthy
CGAACTACGGTTACCATCCACCCACCTTAGTTCCGCCGCTCGTCTTTCTG	Healthy
AGGGTTGTTCCACGCGTAGCGTCTTTTTGGGACACGTTCTAACTACAACA	Healthy
TATGCATGTGCGCATGTTAGAGATGGCGCCTCTTTGGACGGAAGCGCCTG	Healthy
CTTCACGCATGCGGTTAAATTTGGGAGATGTAACTCCCTGGAAGGACCAT	Healthy
AGCCTAGAGCGAGCACTAAGTGGCTCTGAAGACGCTCGGAACTGTCATCA	Disease
GTTTCAGGTGAAAAGAAGGTTTATGGGTGCCTCCATCTGACAGTATGGGA	Disease
CACTACTATCAATGTTGCTAGCGGCCTTCCCCAACAATCGGGTGTTAAAC	Healthy
TACAATGCTAAATGATGTAAGCACCCAGCAAAGTTCCGTTGACTACACCA	Healthy
ATAGATGGCGTAGATTCTGGTCATTCTATGAACTAAGGCCTGATCTCGCC	Healthy
AAGATTGCACAACACTCGAGGTCGCGATCCTTCAGGGCCGCGCGTACTCC	Healthy
TAGATGTCACGACACAGTAGCGGTGCGCTCGGCGAAAAATCCTCCAGACT	Disease
TGACTCGTAGTGACCCATAAAGTTCGCGGTACTGCGAGAGGGGCGTGAGG	Disease
GAAAATGATGCAGGATAAACCCAGGCCCAATGTCCTGTGGCAGTGCTGGT	Disease
AGCACGACTCCCCATCCGTGTACTAGTCCGCAGAAGCCGTTACGCTTTAG	Disease
CCATAGAACGCGATAGGGGTATGTATCTAAAACTAGGCTGTCTAAGGATG	Disease
GGCACCTTTCGTCAGCTAAGCCTACATCGCTGCAGCGCGATCAGGCCCTT	Healthy
AGAAAGAAACGTGCAGAGCGGATCCTTCCCGAGTTTGTAAAACCTGTCTG	Healthy
TAGGGGGTACGTATTCTGCACCCCTCCATACTCGGGTAGCCCTAAAGCTT	Disease
GCCCAGTTACATGGTACGCTCAGAACAAAGAGACCCACTACCCCCGCTGG	Healthy
GCATCGCTATTGCGCATCGTGTTCTCGCTAGTCGAGCAGTTACAGCTCAC	Healthy
AAACACAATAAGCCTGGAGAAGTCTGTCCATCCCCACCTTCTGTTTATAG	Disease
ATAGATCTGATGACCCTCAGTGTCTCGACTCCCGCGAGTGGCAGTCTCTC	Disease
GTGCACCGTCATGGACGGTTGCTCTAAATTTGGCTTCGTATTGGCGAGCA	Healthy
TCTCAAAGAGAAGGTCTCCCCCTGTCCCCCGGTTTACGGGCGTCTCCTCC	Healthy
ATGCGTCGCCAATGAACGCTGGTCGGTACTGACAGACGAGTTAGGCAGAC	Disease
ATGATTGTGGACGGTATGGCTAGATGGGAAGGGCGGATGTCTCTAGAATT	Healthy
GTGATAAGAACTGCCCGATCTCTGCAGTCATACAACTCCGCGATACTAGG	Disease
CCTGTCGGGACGGGTAGGCCTCTACGTTTAAACTGAGACCCTTTCTGAAG	Disease
CGGCGTAAAGGCCCACAATTATTGATATGAACTTCCTAACGAGTCGGGGG	Healthy
CGCACTGGGCGGGTGTTACGGCTGTGAGCACTGAGACTTCATAGGATTCG	Disease
TTAAACATATATAAATATTTGGGAGTCCTGCGCGTAGACGTTGAGGAATG	Disease
ACTGTTTATCGCACTACCTATATTGGTAGTGCGAAGCGCAAAGCCAAGTA	Healthy
GACAAATCTAAGTCTGACGACAGAAGATGGACACGGCATTTTGTGACCCT	Disease
TCAATTTACGTGGTGGTAGAACGACTCCTCGAGCCTACAGATGGTATGTA	Healthy
TCTTGATAATGGACAGAGTCCCACCGGAGCGGGTCATGCGTACATGTCAC	Disease
CCCTATGGAGTCATATAGGACTTGTCTTTCGGGAGGGCGCCTGCATTTCT	Healthy
AACTGTGAATAACGATGCCGGGTAACTGATAACCCTATTACTTTCGCAGA	Disease
GTCCTGACACAGCAGTGTGAAACGCGTCCGCGAAGTTCCTGCTTTAGTCA	Healthy
AGGTCAAACGCCGGGGGGTCTGACAAGGCACTTTCCTCACTATGCTTAAC	Healthy
ACGGGAGACCAACACTACTTCTGGAAACGCGATTTAGACCCCCAAGTGTG	Healthy
TGCTAGGCTGTAGTCATCTTTCTAGGGAGCTACGACAGAATCAGAACCCA	Healthy
ACTTCGTCTGGCTCGGGAGAAGAGCCTTAGCGCTCCGGTTGGATCTCTCC	Disease
ACAGTTATGAACTGCACGCCGAAAAAGGCTACTGCGAGGTTTATCCCTCG	Healthy
GTGTTTAGTTACCGGAGCCTTCTATCGGAAATGATGACTTCTATGTGTGG	Disease
ACGCCTCTCATTTGAAGTGTGGTGATGGCAATTGGGCTTTTGGCGAAAAG	Healthy
CGAAGGTTGCCATCATGGATGAAGAAAATAACAAGTATCATCGTGAGATT	Disease
AAGCATCGCCCATCATACACTTTTAAGCAGAGATGGGTTATAAAATAACT	Healthy
AGTAATCATCATTAGGCTTGGTAAAGCGTTCCAGTAACACCGTAGCGGGC	Disease
CCGCACGAAGGGCATATATCGTCATAGAAATTAAGACTCAGAACCCAAAC	Disease
CTCAGGTCGACAGCAAGCAGATTTGTTAAACCACATTCTATGTCAGTTCC	Healthy
AACTCGGTTCCTTTATGCACAGGAATTACTGCAGCTTGACACGTTGTAAG	Disease
CAGGGCGTTAAGGGTTGTGACCACTACACTATCATGCCGTGGCTAGGTTC	Disease
CTACCCTCTTTGTTTAGGGCTAAGGGAATCCTCACCTACTGACGGACAAG	Healthy
ATCTGTAGGTAATACACCCTCCTTACTTACATATACTTAGGCGGTCAAAG	Disease
GCGGAAGTCATCCATACCGCAAGGATGGTTACTTACTTACGTCCAATCTG	Disease
AGTCTTATAAGGGCGTGGATAGTAGGCGAAATTGAGTTATCTGCACGCGG	Disease
GTCCACTGAGCCAGTAGCTCAAGGTTCCCCAAGAGCCCAGGTATAGCCAC	Healthy
CGACTCTGCGTGTAATCCCCCGATGTAGCGGCTGCACCTGAACTCAATCT	Healthy
CAGCGCTAGATAATGAATATCTGTGCGAATGCTTTTCCGCGTCAACCGTG	Healthy
TCGTACCATAGCCGGTACTTTCTGTGCGGGCCTGTTCAGGGTACCAGGGC	Disease
GATTGGAAATTGGAGCGCTAATCGATTCATAACGCCTGAAGAACATACCG	Disease
CAGGGCGGGGATGCTACTAGACTCTTACCAGTGTTCGATGGATGTATGTG	Healthy
TGCTCCTCGTAGGTTCGTAACACAGTAGGGGTAGCTAGGTTGGCAAGGCT	Disease
GGCGGTCGTTATTGACTCCACCAGCTGTGCTGGTTGCTGTTTCAGGGAGC	Healthy
TAGTGACTAAGGCCGATGCCAACGGTGGTCCTTGAGAATCCCAAGCAGCC	Disease
ACTATCCTGTGGATCATTCGCTGGTAAGTATGTGACTTTTAAATTATCCA	Healthy
GGGCCTCTCGATGGTGTCGGGGGTGCGATAATTCATTGACGCCCCGCTTA	Healthy
TGGACCAACGCGTCGATCGTGCGTAGAGCCGGATTATCTCAATCCGGCCG	Disease
CTTTAGTATTCTATTCACTCCATAACTAGACTTCTTCAAAGAGAACCCCA	Disease
CCTTCCCGATACCAATTTGTGTCCATTAGGGGTTACGAATGGTGTTCGCG	Healthy
CATAGGGACGCACGTGGTTGATGCAACTCTAAGAGCTATTACAAGCACCA	Healthy
ATCTGACCCACAGTCGAGGTGCTAACCGATATGAATGTTAACAACCGTGT	Disease
TGCAGACCACCTTACCGACATCATTCGTTTTAACGCCATTTAGCGCCACG	Disease
GGTCGACCGTGGACGTCTCGAAGAAATAGATAGGGCATCGGTCTTAGTCC	Healthy
GGTTTTCCTCCCGAGGATCATGCCCACTTAACACATTTCCTTTTGGAATC	Healthy
ACGTAGCAGCCCTGTCTCACGCTCCAATGATTCGGTTGTCCGCGCTTCCC	Disease
ACTCGCGCTCATCCCGGATCAATGAAGCGCACGATCAGCGGTCCGGACTC	Healthy
GTTTACTAGAGGGTCAAAATTATTCCCACGGCGTTAACTCAAGTGCTCTC	Healthy
TTACCCTCTGTCAGACGTTTGGATCGAGGATGTCACGGGATAAGACATGT	Disease
GGTAGGTTTCAATTTAGGGAAGCACGTAACATGATCATGTGCCGGCCTAA	Disease
CAGTTTGACCGTGTCGATTAGGTTAGTGCGTGTGTAGTGTGCTTGAACGA	Disease
GATGAGGCGCCGCATAACACTCCTCCATGCGAACGCTACATTTACGGGCC	Disease
GAAGTAGGAGTCAAGAGACGTAGCTAATGATTGGGGAACTTAGCAAAGCT	Healthy
GAAAACTTGTACAGTAACCTAGCTTAATGTGACATCATTAGTCCGAAGAG	Healthy
CTGCCCCGAAAGCGACGTGTTCACAATTGGAGAAACCTCGGTGTACTGAG	Disease
CGAATCGACTCACATCTTAGACCTGATGCGCATAATGGCGGGGCTCAACA	Disease
CACTAACACCCGGTCCTGCACATTCCCCTATCTACTTGCAAGCGGCCGGA	Disease
GACACAGGGATCAATCTGGTAGTCTCTTCGATGGCATGACATGTCCCCTT	Healthy
GGACGTAAACAGTTAGTTTGTGCAGATCGCGCAGCGCCTAGCAATGATTA	Disease
GCCTGTCTAACTTCCCACGTGACGGTCAGTACTAACCGACACGCTAATAC	Disease
TACTTCGGGCCTATTACCTCTAAAACAGAAGTCAAGAAAGCAAGCGCTGA	Healthy
CATCAGATCAGATACCCACAGACGACAAGCTATACATTTATTGAGTTTTG	Disease
TCTCCTCCAAGGAAAAGAAGGAAGGCCGGTTCTGATACTTCATGGCGTAT	Healthy
AGGGATTCGATAACGACGACAGGCCTTGACGTGGCCCACATGAATGGCGC	Healthy
AGGTCCGACCGTAGCACAGTAAGCTAGATATAGACGGGACACTTCTAATG	Disease
TTAATTTCGGGCTTATACTCGCATAAATGGTTACTTAAGCCGATAATTGT	Healthy
CAAAGTTGTGCAGGCTGCGATGATCGCCAGAGACGGGTCCTCCGTTTAAT	Healthy
GCTCGAGTAACTTATAAGACATCCGCAGCTACTGATATTCGTTGGCGCGA	Disease
TACACTAGTCATGATCACGTGAGATGACACCACAATCGCGAAGGAACAAA	Disease
GGTATTCGGATCGTTGTCATGAACTATGTGAGACCGTGGGAAACAGCGGA	Disease
AGGGAATACCTCGTATAGAATCTGCTGCTGTAGTTACGCGCCGGGGGTGT	Healthy
TGACTTGGGGTGTACCGTATTAATTCTATTCAATCGATTACCGCCCGTTA	Healthy
CACCCGGTAGTGTTGCATGATAACTACCGCTGACCGCGCTCCAGAGTCTA	Disease
CTCCCGATAGGCAACTCCCCGCGCTCATGTTATATTCGTCGTTTTGAATC	Disease
CACCCCGTCGTAGTCGAATTGAACAAGATTTGTTCAGTTCGCGATGCAAG	Healthy
GATGCAGTGGAAAATTAAGTCGGTCCATGGCGTCACGTTCTGCAAAATGC	Healthy
CCCACGAGCGCCAGTCGAACTCGCCGCTTCGATCTGGAAGTATAAAATGA	Disease
TATACACTCGGTCCTTATGAAGAATATCCTTCGCTGTCGGGCGAGACCGT	Healthy
ATAGTTGACAAGTGCATTGCCATGAGTGCGATAGACGCCGTGCGCATCAT	Healthy
ACGAGTGACTTTAATTGGGTCTAAATACACGGAGATGCACGCGCGCGCCC	Disease
AAAGCGTTACCCAGTCTACCGATGCGAGTTTAAGTGAAAAGCACCTCCTA	Healthy
GACTAGCTACTATGTCTTCTGTAGCTAACTATGATGTCCAACTAGGGTTC	Disease
GTCGCTTAAGCGCGGAGCACCTCTAGCGCCATACTGGTGTCGCACGCCGC	Healthy
ACGTTCATGCGCATTACATTGCGCCTCGAGGCATTTGTGTCAGGAGCCCA	Disease
GATTGGAAAAGCCGAGTTCCGAACTAAACCTCTGTGGGGAACACGCTATT	Healthy
CGTTTACCCTTGACCCTTGCAGCGTAGGGTCTCGGATTAGGCTACTCGTA	Disease
TTGATCTTAACACCGTCAAATCCGGTCGGCAAAATTCATATAAATTATAG	Disease
GAGATCGCCACCTGCTTGAAAATTCTTGTTCTCCCCCCTTTGAAACGCAG	Disease
TAGCGCCGGAGTCCACCCAGTTATGGTTTCGAGGTGTAACGCACCGGAAC	Disease
TTAATACCCGCGAATCCGCGCACAACATATCTAAAGGCTCAAGCCAAGAA	Healthy
CATCAACCGCACCCTTATGGGTGCGAACTCCCACTTTTCGATACACTTGA	Healthy
TACTAGCTCTTCAGAGAACTAGGTTAAAGAGATCATCTACCGGTTCATCG	Healthy
TATATGCAGGACGCAAGCCTTCTAGCACGTTTCAGCCGTACACGATGGGT	Healthy
GGCGCGTGGTGCAACAACGATCTCACGTATGTTAGTGAGTCGGCTTGAGC	Disease
CGGCGCCGAGGTTATAGACTGGGCGGGTCCCCCTCCCGATACGTGACATG	Healthy
GGAGCGTAGTACTTTCGATAACACGGGGATTGAATGGGGCGCCCTTGGAT	Healthy
CAAAGTGTTCTATTCTAACTTCTGGCACACCGATGTGGGCCTCTAACTCT	Disease
CATAGGGAGCGCACGTGATTAAGTGCAGACAGATTGCGATGGGAAATTGT	Disease
GACTGACGTAGATCGCTTGGAGCCACAGTACGGACAGCCCGAAAATATCC	Healthy
GTCAAAGAGCATCATCTTATTTTTGCTATTGCAGCGCGCCTAAGTCCGCG	Healthy
GGCCCGACCGATATTTACGTATGAAATACTCCAATGGTACATTTTATCCT	Healthy
ATTAGGTTGCAATCAAATGGTGTGGGACTGGCGCACGTGCTAAGATAACC	Healthy
TGTATGACCGGACGTATTGGGATCTGCCAGCTGATACTGAGGCATCCCGT	Disease
TTGATCTGAATGTGAGTCGTGAATGGTAAACGTGTTCTGGCACTACTTTT	Disease
ATACTGACGATACGACCGAACGTCTAGATATAATCGAACCGATGTCTGTA	Healthy
CCCCGGGAAGTTTCCAGGGTTTCACACTAGTTGGAACTGCCTCATAACAT	Healthy
TCTCATTGGCAAGCTGTGGCAGTCCTCTAACCTGATCTTTTAGAACGCTC	Disease
TCATTATACTTACCGCGTGGACAGTACCAGGGATGCTGATGTGCCACCAA	Disease
GTGAAAGCCCTAACGAGATCTCGTCGTAAGAGTGTGCTGACTGCCATAGC	Disease
TTACGTCTGTCCCCCTGAAAGGCCCCGTAGAGAGGTCCTTCCATAATCTT	Disease
GAGCGTGAGCCATTGTTACACAACGTCATCGACATTCGTTAACACAGATA	Healthy
GCGTGGACTGAAATTAGCGTCTACGTTCATATAGTGCGCTGGTCTTATTC	Healthy
GATACTCATTGAGGACCGCTGTTTTGTCTTCGTCTGGCTAACCAGTGCGA	Disease
AGAGTTTATAAGTAAAACCGGAAGTGGCCGCTTGAGGCCCTTATAGGTTA	Healthy
AGGAACAGATCTCAGAAGTCTGTCATACCACGAGGACACAAGTAAGGATG	Disease
GTTTTTTCCTGACGTTAGAGCGCCAACTCACCTGGAAGTATCTGCTCCAT	Healthy
GCTATCTTAGCTCATCAGGCTGGACAGATCTCACTATATTCCGCTCTCTG	Healthy
CCTCTCCTTTTAGTTATACGTAGCTGCAATTAACTCAGTAGGCATACGAA	Healthy
CTTTCCTGCTGCACACGTGATATCTCATGCTTATCTACATTCACGTCTCG	Healthy
GGGGCGATCTAGGACAGTCATTTCCCAAAAGACCATGCGCGTATACGATC	Healthy
AAATCCCTCCCGAGGGTTAGTGCCGGTTTTGTCGCTGTAGTCCCTATCTA	Disease
ACGCACATTGTATCGGAGCACTTGGGGACGATAGTTCATCGAACAACCAT	Disease
GTACGCGCCATCACCTCGTTTGTGCCAAGTTTCATCTAGCGTACTACAGA	Disease
GTCCACTTTGCAGGGGGTTTAGAGGAACGGTGATCATAGGGTCGCTAGAT	Healthy
TCCCAATCATTTCTGACCAGACGTCAATCCCGTAGCCCCCTATTAGACCT	Disease
ATGACCTTCTCTGCTCTCGTATTTGACCCGATGATCGGGATCGTGGCGTA	Disease
AGTTAGGAATGAACTAACCTACCTAAGCCCTACGAGTTGCATGGCTCCCT	Healthy
GTTGCGCCACCAGTATTGTCGCAAGCGTAATATCGGCAAAATCCGCGCTG	Healthy
ACGACACTGGTCCGTTTATACGCCGGCAAGCAACATATGTGGCACAAAGG	Disease
CTAGTTCGAGAAAAAACCCGCGTGCGAGGCTTTTATGTCAAGACTAGGAA	Disease
TAAACGGAGACACCCCCCCAGTGCCCCAATTCGGGCTCTGAACGGAAGTT	Disease
CGACCATTCGATGAAAGGGACTTCCCGACTTGTTGGCTAGGCTTGTCTGG	Disease
GCGTCCGAGTTGCAACGTAAGTGGAATCATTTGATCATGCGCGGCGCGCA	Healthy
ACTGGTCTTGTCACTTGTTCTCCCCTGGGCCTCCAGTCAGTCTAGACAAG	Disease
GAGCCTTATGCTACCGGCCTAGCACGTTTGCGCGATGACGGGATAGCATG	Healthy
CTCTGGCAACACCGAGAGTAATAAATAATATCCCTTTATACAGAAACCCG	Healthy
GTGATGAGAGCCAGTCGTTACCGTTTTCAAGACAATACTATTATAGTGAT	Disease
GGTTGTTCCAGCGATTATCCTACAACATAACGTCGAAGCTGATGTCAGGG	Disease
GCAGGTCTGCAGCATTAAAACGCCAAGTAATGCTTAAACGAGGGAACTCA	Healthy
AACTGGGCGCGGCTCCACACGCTCCTTGTCCAGGGCCATCGCGTGACCCC	Disease
TGTTAAAGAGCCGGTTTTTGTCCTTTATCTCAACCTCAGAACGGCAGTGT	Healthy
CTTAGTGGGCAAGAACGCCGACAGAGACTCAACGTGATGGGTGACTCGCT	Disease
ATTTGGGCTAAGTAATCCGGATGAAGCCGGTCAGCTAAACAACCGGCCTG	Healthy
AGGTTCTGTTCATGTCAACCAAATAATAATGGGTCTGCGTCCAGGGCGAC	Healthy
GCGTCTCAAGGATAAGTCCGCATTATAGTGCTTCTATTACTTCGTCGACT	Disease
CGGATGGTGAATGCACTGTTCGGGATGTGCACTTTTCACACTGTCCTAGC	Disease
